# 예시 코드
def erase(x, y):
    board[x][y] -= 1
        
board = [[1, 0, 0, 0, 0, 1, 0, 0, 0, 0],
[0, 0, 0, 0, 1, 0, 0, 0, 0, 1],
[0, 0, 0, 1, 0, 0, 0, 0, 1, 0],
[0, 0, 1, 0, 0, 0, 0, 1, 0, 0],
[0, 1, 0, 0, 0, 0, 1, 0, 0, 0],
[1, 0, 0, 0, 0, 1, 0, 0, 0, 0], 
[0, 0, 0, 0, 1, 0, 0, 0, 0, 1], 
[0, 0, 0, 1, 0, 0, 0, 0, 1, 0], 
[0, 0, 1, 0, 0, 0, 0, 1, 0, 0], 
[0, 1, 0, 0, 0, 0, 1, 0, 0, 0]]