Test case
<문제설명>에 해당하는 파이썬 코드를 작성한다. 결과는 파이썬 코드 및 제약조건 만족여부만 출력한다.
(배열, 명령어는 따로 정의할 필요 없다.)

- <패턴 설명>에서 '패턴을 이해하지 못했습니다.' 문구 출력시 'for문'을 사용할 수 없다. 1이 저장된 모든 위치를 찾고 각각 명령어를 적용하여 파이썬 코드를 작성한다. (제약조건 무시)

- 제약조건을 만족하는 경우 '제약조건을 만족합니다.', 제약조건을 만족하지 않는 경우 '제약조건을 만족하지 않습니다.'를 출력한다.

#1. 제약조건 : 반복문 2개, 커맨드 1개
[[1, 1, 1, 1, 1, 1, 1, 1, 1, 1],
[1, 0, 1, 0, 1, 0, 1, 0, 1, 0],
[1, 1, 1, 1, 1, 1, 1, 1, 1, 1],
[1, 0, 1, 0, 1, 0, 1, 0, 1, 0],
[1, 1, 1, 1, 1, 1, 1, 1, 1, 1],
[1, 0, 1, 0, 1, 0, 1, 0, 1, 0],
[1, 1, 1, 1, 1, 1, 1, 1, 1, 1],
[1, 0, 1, 0, 1, 0, 1, 0, 1, 0],
[1, 1, 1, 1, 1, 1, 1, 1, 1, 1],
[1, 0, 1, 0, 1, 0, 1, 0, 1, 0]]